11111111111111111111
10E00100000000010001
10P00100001000010C01
10000100001000010001
10000100001000010001
10000000001000000001
11111111111111111111
