111111111111
1000EPC00001
100000000001
111111111110
