111111111111
1000000001C1
100P00000011
10000000E001
111111111111
