111111111101
1000EPC00001
100000000001
111111111111
