11111111111
100PE010001
100000100C1
100000100C1
11111111111
