11111111111
100PE000001
10000000001
11111111111
