111111111
100000001
100000001
1111
