111111111
100000001
100001
111111111
