11111111111111111111111111111111
10E0000000000000000000000C000001
10000000000000000000000C00000001
10000000000X000000000C0X00000001
10000000000X00000C00000X00000001
10000000000X0000000C000X00000001
1P000000000X00000000C00X00000001
11111111111111111111111111111111
