1111111
100000001
100000001
111111111
