111111111
1EEP00001
111111111
