1111111111111
1000000P1E001
1111111111111
